%%%%%%%%%%%%
%%%%%%   G%%
%oP ...%%%%%
%   %%.%%%%%
% %%%%.%%%%%
%G%%%%.%%%%%
%%%%%%.%%%%%
%%%%...%%%%%
%%%%%%%%%%%%